asset = activo

rank = puntaje

thumbnail = vista en miniatura

post = publicacion, publicar

non-word characters = caracteres no imprimibles

workflow = flujo de trabajo

version tag = etiqueta de version

login = ingresar

plugin = plugin

item = item

SQL Query = Consultas SQL (Peticion SQL)

Setup = configurar 

Set = establecer

Proxy = proxy

Pixels = pixeles 

Gateway = Gateway

Macro = Macro

Cron = Cron

Page Layout = Diseno de Pagina

Dashboard = Panel

Dashlet = Elemento

Data Form = Formulario de Datos






Equipo de traduccion VCB:


    Lisette Ramirez

    Tita Ochoa

    Frank Olaya

    Juan Guillermo Gallego

    Estiven Restrepo

    Camilo Soler

http://www.vcb.com.co -- soporte@vcb.com.co

Colaboracion en Traduccion
    
    Juan Manuel Mesa (overdrive3000)
    Juan Mejias (algolius)

    Marcela CF Saiffe (Mexico)

Usuarios WebGUI de Venezuela



